---------S----------
----___________-----
----_o-------o_-----
----_---------_-----
----_---------_-----
--___----o_____-----
--_----____---------
--_o---_-o_---------
--______--___-------
------o_----_-------
-------_----_-------
-------_----_o------
-----___----___-----
----o_-------o_-----
----__-----_____----
----_------_---_----
---o________-o-_----
--___----------___--
--_o------------o_--
--____B------B____--
