---S----------------
-_______________----
-_o-----------o__---
-________-------__--
--------_o-------_--
--________________--
--_o-------------_--
--__-----------___--
--o_____________----
---------_-_--o__---
---------___----__--
----------_----o-_--
--________________--
--_o--------_-------
--__--------_-------
---_o------o___-----
--___----o----__----
--_o_________--_----
--___-------____----
----_B-----------o--
