---------S----------
--------___---------
------___-___-------
----___----o___-----
---__o_-------__----
--__--__-------__---
--_----__-------_---
--_o----__-----o_---
--__-----__----__---
---__-----___o__----
----___o----___-----
------___-___-------
--------___---------
--------o_o---------
--------___---------
-------__-__--------
------__--o__-------
------_--o--_-------
------__o--__-------
-------__B__--------
