------S-------------
----o______o--------
--____----___-------
--_-o------o_-------
--_---------__------
-o______o----_------
-------_______------
------o_-----__o----
-------_------_-----
-----o-_---o--___---
-----_____-----o__--
-----_-o-_-------___
----__---__-------o_
---__-----__-----___
---_--o----__-o-__--
-o-__-------_____---
----__--------_-----
----o_-________-----
-----___o------o----
------B-------------
